.....................
.....................
.....................
.....................
.....................
........###..........
.......##.#.####.....
......##..###..#.....
.....##........#.....
.....#...@..#..#.....
.....###..###..#.....
.......#..#....#.....
......##.##.#.##.....
......#......##......
......#.....##.......
......#######........
.....................
.....................
.....................
.....................
.....................
