###########
#.#.#.#..##
#.........#
##........#
#..@..#...#
#.........#
##.##....##
#..####.###
#.......###
###.....###
###########
