###########
#...###...#
#...###...#
#...###...#
#...###...#
#...###...#
###########
###########
#..#####..#
##...@...##
###########
